{
  "name": "Level 1 - The Beginning",
  "width": 25,
  "height": 19,
  "tileSize": 32,
  "playerStart": {
    "x": 50,
    "y": 100
  },
  "enemies": [
  ],
  "tiles": [
    [4,4,4,4,4,4,4,4,4,4,4,4,4,4,4,4,4,4,4,4,4,4,4,4,4],
    [4,4,4,4,4,1,1,1,1,1,1,0,0,0,0,0,0,0,0,0,0,0,0,4,4],
    [4,4,1,1,1,1,0,0,0,0,0,0,0,0,0,0,0,0,0,0,0,0,0,4,4],
    [4,1,1,0,0,0,0,0,0,0,0,0,0,1,1,1,0,0,0,0,0,2,0,4,4],
    [4,1,0,0,0,0,0,0,1,1,0,0,0,0,0,0,0,0,0,1,1,1,0,4,4],
    [4,1,0,0,0,0,0,0,0,0,0,0,0,0,0,0,0,0,0,0,0,0,0,4,4],
    [4,1,0,0,0,0,0,0,0,0,0,0,1,1,0,0,0,0,0,0,0,3,0,0,4],
    [4,1,1,0,0,0,0,0,0,0,0,0,0,0,0,0,0,0,2,0,0,0,0,0,4],
    [4,4,1,0,0,0,0,0,1,1,0,0,0,0,0,0,0,1,1,1,0,0,0,1,4],
    [4,4,1,0,0,0,0,0,0,0,0,0,0,0,0,0,0,0,0,0,0,0,0,1,4],
    [4,4,1,1,0,0,0,0,0,0,0,0,0,0,2,0,0,0,0,0,0,0,1,1,4],
    [4,4,4,1,0,0,0,2,0,0,0,0,0,1,1,1,0,0,0,0,0,1,1,4,4],
    [4,4,4,1,1,0,0,1,1,0,0,0,0,0,0,0,0,0,0,0,1,1,4,4,4],
    [4,4,4,4,1,2,0,0,0,0,0,0,0,0,0,0,0,0,2,1,1,4,4,4,4],
    [4,4,4,4,1,1,2,0,0,0,0,0,0,0,0,0,0,2,1,1,4,4,4,4,4],
    [4,4,4,4,4,1,1,0,0,0,0,0,1,1,0,0,0,1,1,4,4,4,4,4,4],
    [4,4,4,4,4,4,1,1,0,0,0,0,0,0,0,1,1,1,4,4,4,4,4,4,4],
    [4,4,4,4,4,4,4,1,1,2,2,2,2,2,1,1,4,4,4,4,4,4,4,4,4],
    [4,4,4,4,4,4,4,4,4,4,4,4,4,4,4,4,4,4,4,4,4,4,4,4,4]
  ]
}

