[
  {
    "name": "Tower Climb",
    "width": 25,
    "height": 19,
    "tileSize": 32,
    "playerStart": {"x": 384, "y": 512},
    "tiles": [
      [4,4,4,4,4,4,4,4,4,4,4,4,4,4,4,4,4,4,4,4,4,4,4,4,4],
      [4,4,4,4,4,4,4,4,4,4,1,1,3,1,1,4,4,4,4,4,4,4,4,4,4],
      [4,4,4,4,4,4,4,4,4,4,1,0,0,0,1,4,4,4,4,4,4,4,4,4,4],
      [4,4,4,4,4,4,4,1,1,1,1,0,0,0,1,1,1,1,4,4,4,4,4,4,4],
      [4,4,4,4,4,4,1,1,0,0,0,0,0,0,0,0,0,1,1,4,4,4,4,4,4],
      [4,4,4,4,1,1,1,0,0,0,0,0,2,0,0,0,0,0,1,1,1,4,4,4,4],
      [4,4,4,1,1,0,0,0,0,0,0,1,1,1,0,0,0,0,0,0,1,1,4,4,4],
      [4,4,1,1,0,0,0,0,0,0,0,0,0,0,0,0,0,0,0,0,0,1,1,4,4],
      [4,4,1,0,0,0,0,0,2,0,0,0,0,0,0,2,0,0,0,0,0,0,1,4,4],
      [4,1,1,0,0,0,0,1,1,1,0,0,0,0,0,1,1,1,0,0,0,0,1,1,4],
      [4,1,0,0,0,0,0,0,0,0,0,0,0,0,0,0,0,0,0,0,0,0,0,1,4],
      [4,1,0,0,0,2,0,0,0,0,0,0,0,0,0,0,0,0,0,2,0,0,0,1,4],
      [4,1,0,0,1,1,1,0,0,0,0,0,0,0,0,0,0,0,1,1,1,0,0,1,4],
      [4,1,0,0,0,0,0,0,0,0,0,0,0,0,0,0,0,0,0,0,0,0,0,1,4],
      [4,1,1,0,0,0,0,0,0,0,0,2,0,0,0,0,0,0,0,0,0,0,1,1,4],
      [4,4,1,0,0,0,0,0,0,0,1,1,1,0,0,0,0,0,0,0,0,1,1,4,4],
      [4,4,1,1,0,0,0,0,0,0,0,0,0,0,0,0,0,0,0,0,1,1,4,4,4],
      [4,4,4,1,1,1,2,2,0,0,0,0,0,0,0,2,2,1,1,1,1,4,4,4,4],
      [4,4,4,4,4,4,4,4,4,4,4,4,4,4,4,4,4,4,4,4,4,4,4,4,4]
    ]
  }

]